//1,2,3,4,5,6,7,8,9,10,11,12,13,14,15,16
1,1,1,1,1,1,1,1,1,1,1,1,1,1,1,1
1,0,0,0,0,0,0,1,20,1,0,0,0,0,0,1
1,1,1,0,0,0,0,0,100,0,0,0,0,1,1,1
1,20,1,0,0,0,0,0,0,0,0,0,0,1,20,1
1,0,0,0,0,0,0,0,0,0,0,0,0,0,0,1
1,0,0,0,0,0,0,1000,0,0,0,0,0,0,0,1
1,0,0,0,0,0,0,0,0,0,0,0,0,0,0,1
1,1,1,0,0,0,0,0,0,0,0,0,0,1,1,1
1,20,1,0,0,0,0,0,0,0,0,0,0,1,20,1
1,0,0,0,0,0,0,0,0,0,0,0,0,0,0,1
1,0,0,0,0,0,0,0,0,0,0,0,0,0,0,1
1,1,1,1,1,1,1,1,1,1,1,1,1,1,1,1
