//1,2,3,4,5,6,7,8,9,10,11,12,13,14,15,16,17,18,19,20,21,22,23,24,25
1,1,1,1,1,1,1,1,1,1,1,1,1,1,1,1,1,1,1,1,1,1,1,1,1
1,0,0,0,0,0,0,200,0,0,0,0,0,0,0,200,0,0,0,0,0,35,0,27,1
1,0,0,0,0,0,0,0,0,1,1,1,1,1,1,0,0,1,1,1,1,1,0,0,1
1,1,1,1,1,1,1,1,0,0,0,0,0,0,1,1,1,1,202,0,0,1,1,1,1
1,0,200,0,0,0,0,1,0,0,0,0,0,0,0,0,0,0,0,0,0,0,0,0,1
1,0,0,0,0,0,0,1,1,1,1,1,1,38,0,0,0,0,0,0,0,0,0,0,1
1,0,1,1,0,0,0,0,200,0,0,0,1,1,1,1,1,1,1,1,1,1,0,0,1
1,0,0,1,1,1,0,0,0,0,0,0,34,0,0,0,0,0,0,201,0,1,1,0,1
1,0,0,34,0,1,1,1,1,1,1,1,1,1,0,0,0,0,0,0,0,0,1,0,1
1,0,0,34,200,0,0,0,0,0,0,0,0,1,1,1,1,1,1,1,1,0,0,0,1
1,1,1,1,0,0,0,200,0,0,0,0,0,0,0,0,0,0,0,0,1,1,1,0,1
1,0,0,0,0,0,1,0,0,1,0,0,0,0,0,0,0,0,0,0,200,0,1,1,1
1,0,0,0,0,0,1,37,0,1,0,0,1,1,1,1,1,1,0,0,0,0,0,0,1
1,1,1,1,1,1,1,1,1,1,1,1,1,,202,0,0,1,1,1,1,1,0,0,1
1,0,0,0,0,0,0,0,0,0,0,0,0,0,,0,0,0,0,0,200,0,0,0,1
1,1000,0,0,0,0,0,0,0,0,0,0,0,0,0,0,0,0,0,0,0,0,0,0,1
1,1,1,1,1,1,1,1,1,1,1,1,1,1,1,1,1,1,1,1,1,1,1,1,1
